....................
....................
....................
....................
....................
....................
....................
....................
..........#.........
..........#.....@...
####################
####################