........................................
........................................
........................................
........................................
........................................
........................................
........................................
........................................
........................................
........................................
........................................
........................................
........................................
........................................
..................###...................
..................###...................
..................###...................
..................###...................
..................###...................
.........*........###........@..........
########################################
########################################
########################################
########################################